0000000000000000000000000
0111111111110111111111110
0101000000000000000001010
0101111111111111111111010
0101000000000000000101010
0101010111110111110101010
0101010101000000010101010
0101010101111111110101010
0101010101000001010101010
0101010101022201010101010
0101010101022201010101010
0101010001022201000101010
0100010100022211010100010
0101010101022201010101010
0101010101022201010101010
0101010101000001010101010
0101010101111111010101010
0101010101000001010101010
0101011111110111111101010
0101010000000000000001010
0101111111111111111111010
0100000000000000000001010
0111111111110111111111110
0000000000000000000000000
